; 0
1111111111
1111111111
1141001111
1111001111
1111111111
1111111111
1111121111
1111111111
1151111111
1111111111

; 1
1111111111
1111121111
1111111111
1151111111
1111111111
1111111111
1111111111
1141001111
1111001111
1111111111