; 0
0000000000
0111111110
0141001110
0111001410
0111111110
0111411110
0111020000
0211111110
0151112110
0000000000